EGEGEGEGEGEGEGEGEGEGEGEGEGEGEGEGEGEGEGEGEGEGEGEGEGEGEGEGEGEGEGEGEGEGEGEGEGEGEGEGEGEGEGEGEGEGEGE
GGGGGGGFFFGGGGGGGGGGGGGGGGGEGGGGGGGEGGGGFFFGGGGGGZGGGGGTGGGGGGGGGGGGGGGGTGGGGGGZZZGGTGGGGGZZGGG
EGGGGTGGFFFGGGGGGGGGFFGGGFFGGGGGGGGGGGGGGGGGGGGGGGGGGGGGFZZZGGGGFFFFFGGGGGGGGGGZGGGGGGGGGGGGGGE
GGTGGGGZGGGGGGTGZGGGGGGGGGGEGGGDGGGEGGFFFGGGGZZGGGFFGGGGGGGGGFFGGGGGGGGGGGFFGGGGGGZGGGTGGGGGGGG
EGGGGGFFGGGGZGGGGGGGTGGGGGGGFGGGGGGGGGGGGGGGGGGGGGGGGGGGGTGGGGGGGGGGGTGGGGGGGGGGGGGGTGGGGGGGGGE
GGGGGGGGGGGGGFFFGGGGGGGGGGFEWWWRWWWEGGGGGGFFGGGGTGGGGGGGFGGGTGGGTGGGGGGGFFGGGGGGZZGGGGGFFGGGGGG
EGGGGGGGGGGEGGGGGGGZZZGGGGGGFGRRRGGGGGGGGGGGGGGGGGGGGGGGGGGGGGGGGFGGGGZZZZGGGGGTGGGGGGGFGGGGGGE
GGGGGFFFGGGGGGGGGGGTGGGGGGGGGGRRRGGFFGGGGGTGGGGGFFGGGGGGGGGFGGFFGGGGGGGGGGGFGGGGFGGGFGGGGFFGGGG
EGGGGGFGGTGGGGGGGGGGGGZGGGGGGGRRGGGGGGGGGGGGGGGGGGGFFGGGFFGGGGGGGGGGTGGGGGGGGGGGGFFGGGGGGGGGGGE
GGGGGGGGGGGGGGGGGGGGGGGGFFFGGRRGGGGGGGGGGGGGGGGGGGGGGGGGGGGGGGGGGGGGGGGGGGGGGGGGGGGGFFGGGGGGGGG
EGGGGGTGGGGGGTGTGGGGGGGZGGGGRRGGTGGGGGGGGGWWWWWWWWWWWWWWWWWWWWWWWWWWWWWWWWWWGGGGGGGGGGGGGGZGGGE
GGGGGGGGGGGGGGGGGGGGGGGGGGGFFGGGGGGGGGFFGGWGGGGGGGGGGGGGGGEGEGEGEGEGEGGGGGGWGGGGGGGGTGGGGZGGGGG
EGGGGGFFGGGGGGGZGGGGGGGGFFFGGGGGGGGGGGGGGGWGGGGGGGGGGGGGGGGGGGGGGGFFGGGGGGGWGGGGGGGGGGGFGGZGGGE
GGGGGGGFGGGGGGFGGGGGGGGGGGGGGGTGGGZZGGFGGGWGGGGGGGGGGGGGGFEGGGGGGGGGEGGGGGGWGGGGGGGGGGGGGGGGGGG
EGGGGGGGGGTGGGGGGGGGGGGGGGGGGGGGGGGGGGGGGGWGGGFFGGGGGGGGGGGGGGGGGGGGGGGGGGGWGGGGGGFFFGGGTGGGGGE
GGGTGGGGGGGGEGGGGGGGFFFGGGGGGGGGGGGGTGGGGGWGGGGGGGGGGGFFGGGGGGGHGGGGGGGGGGGWGGGFFGGGGGGGGGGGGGG
EGGGGTGGGGGGGGGGGZGGGGGZZGGGGFFGGGEGGGGGGGWGGGEGGGGGGGGGGGGGGGGGGGGGGGFFGGGWGGGGGGGGGGGGGGFGGGE
GGGGGGFFFGGGGFFGGGGGGGGGGGGGFFGGGGGGGGGGFFWGGGGGGGGFGGGGGGGGGGGGGGGGGGGGGGGWGGGGGGGGTGGGGGGGGGG
EGGGGFFGGGGGTGGGGGGGTGGGGFGFGGGGGTGGGGGGGGWGGGGGGGGGGGGGGEGGGGGGGGGGGEGGGGGWGGGGFGGGGGGGGGFFGGE
GGGGGGGGGGGGGGGGGGGGGGGGGFFGGGGGGGGGGGGGGGWGGGGGGPGGGGGGFFGGGGGGRRGGGGGGGGGWGGGFGGGGZTGGGGGGGGG
EGGGGGTGGGZZZZZGGGGGGZZGGGGGGGGGGFGGGGGGGGWGGGGGGGGGGGGGGGGGGGGRRRGGGGGGGGGWGGGGGGGGGGGGGGGGGGE
GGGGGGGGGGGGGFGGFFGGGGGGGGGGGTGGGGGGGGGGGGWGGGGGGGGGGGGGGGGGGGRRRGGGGGGGGGGWGGGGTGGGGGGFFFGGGGG
EGGFFGGGGGGGGGGGGGGGGGGTGGGGGGGGGGGGGGFFGGWGGGGGGGGGGFFFGGGGGRRRGGGGFFGGGGGWGGGGGGGGGGGGGGGGGGE
GGGGGGGGGGGGGFFGGGGGGGGGGFGGGGGGGTGGGGGGGGWGGGGGFGGGGGGGGGGGRRRGGGGGGGGGGFFWGGGGGZZGFGFFGGGFGGG
EGGGGGGGGGGGGGGGGGGGGGGGGFFFGGGGGGGGGGGGGGWGGGGGFGGGGGGGFFFRRGGGGGGGFFGGGGGWGGGGGGGGGGGGGGGGGGE
GGGGGGGGFFFFGGGGGGGGGGGGGGGGGGGGGGEGGGTGGGWGGFFGFGGGGGGGGGGGGGFGGGGGGGGGGGGWGGGTGGGGGGGFFFGGGGG
EGGGGGGGFFFFFFGGGGGGGGGGGGTGGGGGGGGGGGGGGGWGGGGGGGGGGGGGGGGGGGGGGGAAAAAAAGGWGGGGGGGGGGGGGZGGGGE
GGGGGGGGGGGGGGGGGGGTGGGGGGGGGGGGTGGGGGGGGGWGGGGGGGGGGGGGGGGGGFFGGGAAAAAAAGGWGGGGGGGGGGGGGGGGGGG
EGGGGGGGGFGGGGGGGGGGGGGGGGGGGGGGGGGGGFFGGGWGGGGGGGGGGGGGGGGGGGGGGGAAAAAAAGGWGGGTGGGTGGGZZGGGGGE
GGGGGGGGFGFFGGEGGGGGGTGGGGFGGGGGGGGGGGGGGGWGGGGGGGGGGGGGGGGGGGGGGGAAAAAAAGGWGGGGGGGGGGGGGTGGGGG
EGGGGGTGGFFFGGGGGGGGGGGGGFFGGGGGGGGGGGGGGGWGSGGGGGGGGGGGGGGGGGGGGGAAAAAAAGFWGGGGGGGGGGGGTGGGGGE
GGGGGGGGGGGGGGGGGGGGGGGGGGGGGGGGGGGGGFGGGFWFFGGGGGGGGGGGFGFFGGGGGGAAAAAAAGGWGGGGTZZGGGGGGGGZZGG
EGGGGTGGGGGFFGGGGGGGGGGFFFGGGGGGGGGGGGGGGGWFGGGGGGGGGGGGGFFGGGGGGGAAAAAAAGGWGGGGGGGGGGGFGGGGGGE
GGGGGGGGGGFFFFGGTGGGGGGGGGGGGGGGGGGGGGGGGGWFGGGGGGFFGGGGGGGGGGGGGGAAAAAAAGGWGGGGFFGGGGGGGGGGGGG
EGGGTGGGGGGGGGGGGGGGGGEGGGGGGGGGGGTGGGGGGGWGFGGGGGGGGGGGGGGGGGGGGGGGGGGGGGGWGGGGGGGGGGGGGGTGGGE
GGGGGGGGGGTGGGGGGGGGGGGGGGGGGGGGGGGGGGGGGGWWWWWWGGFFWWWWWWWWWWWWWWWWWWWWWWWWGGTGGGGZGGGGGGGGGGG
EGGGGGGGGGGGGGGGTGGGGGGGGGGGGFFGGGGGGGTGGGGGGGFFGGGGGGGGGGGGGGGGGGGGGGGGGGGGGGGGGGGGGFGGGGZZGGE
GGGGGGGFFGGGGGGGGGGGGGGGGGGFFFGGGGGGGGGGGGGGGGGGGGGGGGGGGGGGGGGGGGGGGGFGGGGGGTGGGGGGGGGGGTGGGGG
EGGTGGGGGGGGGTGGGGGGGGGGGFFFFFGGGGGGGGGGGGGGGGGGGGGGGGGGGFGGGGFGGGGGGZZZGGGGGGGGGGGGFFFGGGGGGGE
GGGFGGGGFFGGGGGGGGGGGGGGGGGGGGGGGGGGGGFFGGGGGGGGGGGGFFGGGGGGGGGGGGGGGGGGGGGGGGGFGGGGGGGGGGGGGGG
EGGGGGGGGGGGGGGGGFFGGGGGGGGGFGGGGGGGGGGGGGGGGGGZZZGGGGGGGGGGGGGGFFFFFGGGGGGGGGGGGGGGGGGGGTGGGGE
GGGGGGGTGGGGGGGGGGGGGGGZGFGGGGGGGGGGGGGGFGGGGGGGGGGGGGGGGGGGGGGGGGGGGGGGGGGGTGGGGGGGGGGGGGGGGGG
EGGGGGGGGGGGGGGGGGGGGGGGGGGGGGGZZZGGGGGGGGGGGGGGGGTGGGGGGGGGGGGGTGGGGGGGGGGGGGGGGGGGGGTGGGGGGGE
GEGEGEGEGEGEGEGEGEGEGEGEGEGEGEGEGEGEGEGEGEGEGEGEGEGEGEGEGEGEGEGEGEGEGEGEGEGEGEGEGEGEGEGEGEGEGEG
