EGEGEGEGEGEGEGEGEGEGEGEGEGEGEGEGEGEGEGEGEGEGEGEGEGEGEGEGEGEGEGEGEGEGEGEGEGEGEGEGEGEGEGEGEGEGEGE
GGGGGGGFFFGGGGGGGGGGGGGGGGGGGGGGGGGGGGGGFFFGGGGGGGGGGGGGGGGGGGGGGGGGGGGGGGGGGGGGGGGGGGGGGGGGGGG
EGGGGTGGFFFGGGTGGGGGFFGGGFFGGGGGGGGGGGGGGGGGGGGGGGGGGGGGFGGGGGGGFFFFFGGGGGGGGGGGGGGGGGGGGGGGGGE
GGGGGGGGGGGGGGGGGGGGGGGGGGGGGGGGGGGGGGFFFGGGGGGGGGFFGGGGGGGGGFFGGGGGGGGGGGFFGGGGGGGGGGGGGGGGGGG
EGGGGGFFGGGGGGGGGGGGGGGGGGGGFGGGGGGGGGGGGGGGGGGGGGGGGGGGGGGGGGGGGGGGGTGGGGGGGGGGGGGGGGGGGGGGGGE
GGGGGGGGGGGGGFFFGGGGGGGGGGFGFFFGGGGGGGGGGGFFGGGGGGGGGGGGFGGGGGGGGGGGGGGGFFGGGGGGGGGGGGGFFGGGGGG
EGGGGGGGGGGGGGGGGGGGGGGGGGGGFGGGGGGGGGGGGGGGGGGGGGGGGGGGGGGGGGGGGFGGGGGGGGGGGGGGGGGGGGGFGGGGGGE
GGGGGFFFGGGGGGGGGGGGGGGGGGGGGGGGGGGFFGGGGGTGGGGGFFGGGGGGGGGFGGFFGGGGGGGGGGGGGGGGFGGGFGGGGFFGGGG
EGGGGGFGGTGGGGGGGGGGGGGGGGGGGGGGGGGGGGGGGGGGGGGGGGGFFGGGFFGGGGGGGGGGGGGGGGGGGGGGGFFGGGGGGGGGGGE
GGGGGGGGGGGGGGGGGGGGGGGGFFFGGGGGGGGGGGGGGGGGGGGGGGGGGGGGGGGGGGGGGGGGGGGGGGGGGGGGGGGGFFGGGGGGGGG
EGGGGGGGGGGTGGGGGGGGGGGGGGGGFGGGGGGGGGGGGGWWWWWWWWWWWWWWWWWWWWWWWWWWWWWWWWWWGGGGGGGGGGGGGGGGGGE
GGGGGGGGGGGGGGGGGGGGGGGGGGGFFGGGGGGGGGFFGGWGGGGGGGGGGGGGGGGGGGGGGGGGGGGGGGGWGGGGGGGGGGGGGTGGGGG
EGGGGGFFGGGGGGGGGGGGGGGGFFFGGGGGGGGGGGGGGGWGGGGGGGGGGGGGGGGGGGGGGGFFGGGGGGGWGGGGGGGGGGGFGGGGGGE
GGGGGGGFGGGGGGFGGGGGGGGGGGGGGGGGGGGGGGFGGGWGGGGGEGGGGGGGGFGGGGGGGGGGGGGGGGGWGGGGGGGGGGGGGGGGGGG
EGGGGGGGGGGGGGGGGGGGGGGGGGGGGGGGGGGGGGGGGGWGGGFFGGGGGGGGGGGGGGGGGGGGGGGGGGGWGGGGGGFFFGGGGGGGGGE
GGGGGGGGGGGGGGGGGGGGFFFGGGGGGGGGGGGGGGGGGGWGGGGGGGGGGGFFGGGGGGGHGGGGGGGGGGGWGGGFFGGGGGGGGGGGGGG
EGGGGGGGGGGGGGGGGGGGGGGGGGGGGFFGGGGGGGGGGGWGGGGGGGGGGGGGGGGGGGGGGGGGGGFFGGGWGGGGGGGGGGGGGGFGGGE
GGGGGGFFFGGGGFFGGGGGGGGGGGGGFFGGGGGGGGGTFFWGGGGGGGGFGGGGGGGGGGGGGGGGGGGGGGGWGGGGGGGGGGGGGGGGGGG
EGGGGFFGGGGGTGGGGGGGGGGGGFGFGGGGGGGGGGGGGGWGGGGGGGGGGGGGGGGGGGGGGGGGGGGGGGGWGGGGFGGGGGGGGGFFGGE
GGGGGGGGGGTGGGGGGGGGGGGGGFFGGGGGGGGGGGGTGGWGGGGGGPGGGGGGFFGGGGGGRRGGGGGGGGGWGGGFGGGGGGGGGGGGGGG
EGGGGGGGGGGGGGGGGGGGGGGGGGGGGGGGGFGGGGGGGGWGGGGGGGGGGGGGGGGGGGGRRRGGGGGGGGGWGGGGGGGGGGGGGGGGGGE
GGGGTGGGGGGGGFGGFFGGGGGGGGGGGGGGGGGGGGGGGGWGGGGGGGGGGGGGGGGGGGRRRGGGGGGGGGGWGGGGGGGGGGGFFFGGGGG
EGGFFGGGGGGGGGGGGGGGGGGGGGGGGGGGGGGGGGFFGGWGGGGGGGGGGFFFGGGGGRRRGGGGFFGGGGGWGGGGGGGGGGGGGGGGGGE
GGGGGGGGGGGGGFFGGGGGGGGGGFGGGGGGGGGGGGGGGGWGGGGGFGGGGGGGGGGGRRRGGGGGGGGGGFFWGGGGGGGGFTFFGGGFGGG
EGGGGGGGGGGGGGGGGGGGGGGGGFFFGGGGGGGGGGGGGGWGGGGGFGGGGGGGFFFRRGGGGGGGFFGGGGGWGGGGGGGGGGGGGGGGGGE
GGGGGGGGFFFFGGGGGGGGGGGGGGGGGGGGGGGGGGGGGGWGGFFGFGGGGGGGGGGGGGFGGGGGGGGGGGGWGGGGGGGGGGGFFFGGGGG
EGGGGGGGFFFFFFGGGGGGGGGGGGTGGGGGGGGGGGGGGGWGGGGGGGGGGGGGGGGGGGGGGGAAAAAAAGGWGGGGGGGGGGGGGGGGGGE
GGGGGGGGGGGGGGGGGGGGGGGGGGGGGGGGGGGGGGGGGGWGGGGGGGGGGGGGGGGGGFFGGGAAAAAAAGGWGGGGGGGGGGGGGGGGGGG
EGGGGGGGGFGGGGGGGGGGGGGGGGGGGGGGGGGGGFFGGGWGGGGGGGGGGGGGGGGGGGGGGGAAAAAAAGGWGGGGGGGTGGGGGGGGGGE
GGGGGGGGFGFFGGGGGGGGGGGGGGFGGGGGGGGGGGGGGGWGGGGGGGGGGGGGGGGGGGGGGGAAAAAAAGGWGGGGGGGGGGGGGGGGGGG
EGGGGGTGGFFFGGGGGGGGGGGGGFFGGGGGGGGGGGGGGGWGGGGGGGGGGGGGGGGGGGGGGGAAAAAAAGFWGGGGGGGGGGGGGGGGGGE
GGGGGGGGGGGGGGGGGGGGGTGGGGGGGGGGGGGGGFGGGFWFFGGGGTGGGGGGFGFFGGGGGGAAAAAAAGGWGGGGGGGGGGGGGGGGGGG
EGGGGGGGGGGFFGGGGGGGGGGFFFGGGGGGGGGGGGGGGGWFGGGGGGGGGGGGGFFGGGGGGGAAAAAAAGGWGGGGGGGGGGGFGGGGGGE
GGGGGGGGGGFFFFGGGGGGGGGGGGGGGGGGGGGGGGGGGGWFGGGGGGFFGGGGGGGGGGGGGFAAAAAAAGGWGGGGFFGGGGGGGGGGGGG
EGGGGGGGGGGGGGGGGTGGGGGGGGGGGGGGGGTGGGGGGGWGFGGGGGGGGGGGGGGGGGGGGGGGGGGGGGGWGGGGGGGGGGGGGGTGGGE
GGGGGGGGGGGGGGGGGGGGGGGGGGGGGGGGGGGGGGGGGGWWWWWWGGFFWWWWWWWWWWWWWWWWWWWWWWWWGGGGGGGGGGGGGGGGGGG
EGGGGGGGGGGGGGGGTGGGGGGGGGGGGFFGGGGGGGTGGGGGGGFFGGGGGGGGGGGGGGGGGGGGGGGGGGGGGGGGGGGGGFGGGGGGGGE
GGGGGGGFFGGGGGGGGGGGGGGGGGGFFFGGGGGGGGGGGGGGGGGGGGGGGGGGGGGGGGGGGGGGGGFGGGGGGGGGGGGGGGGGGGGGGGG
EGGGGGGGGGGGGGGGGGGGGGGGGFFFFFGGGGGGGGGGGGGGGGGGGGGGGGGGGFGGGGFGGGGGGGGGGGGGGGGGGGGGFFFGGGGGGGE
GGGFGGGGFFGGGGGGGGGGGGGGGGGGGGGGGGGGGGFFGGGGGGGGGGGGFFGGGGGGGGGGGGGGGGGGGGGGGGGFGGGGGGGGGTGGGGG
EGGGGGGGGGGGGGGGGFFGGGGGGGGGFGGGGGGGGGGGGGGGGGGGGGGGGGGGGGGGGGGGFFFFFGGGGGGGGGGGGGGGGGGGGGGGGGE
GGGGGGGGGTGGGGGGGGGGGGGGGFGGGGGGGGGGGGGGFGGGGGGGGGGGGGGGGGGGGGGGGGGGGGGGGGGGTGGGGGGGGGGGGGGGGGG
EGGGGGGGGGGGGGGGGGGGGGGGGGGGGGGGGGGGGGGGGGGGGGGGGGGGGGGGGGGGGGGGGGGGGGGGGGGGGGGGGGGGGGGGGGGGGGE
GEGEGEGEGEGEGEGEGEGEGEGEGEGEGEGEGEGEGEGEGEGEGEGEGEGEGEGEGEGEGEGEGEGEGEGEGEGEGEGEGEGEGEGEGEGEGEG
