WWWWWWWWWWWWWWWWWWWWWWWWWWWWWWWWWWWWWWWWWWWWWWWWWWWWWWWWWWWWWWWWWWWWWWWWWWWWWWWWWWWWWWWWWWWWWWW
WGGGGGGFFFGGGGGGGGGGGGGGGGGGGGGGGGGGGGGGGGGGGGGGGGGGGGGGGGGGGGGGGGGGGGGGGGGGGGGGGGGGGGGGGGGGGGW
WGGGGTGGFFFGGGGGGGGGFFGGGGGGGGGGGGGGGGGGGGGGGGGGGGGGGGGGGGGGGGGGGGGGGGGGGGGGGGGGGGGGGGGGGGGGGGW
WGGGGGGGGGGGGGGGGGGGGGGGGGGGGGGGGGGGGGFFFGGGGGGGGGGGGGGGGGGGGGGGGGGGGGGGGGGGGGGGGGGGGGGGGGGGGGW
WGGGGGFFGGGGGGGGGGGGGGGGGGGGFGGGGGGGGGGGGGGGGGGGGGGGGGGGGGGGGGGGGGGGGTGGGGGGGGGGGGGGGGGGGGGGGGW
WGGGGGGGGGGGGFFFGGGGGGGGGGFGFFFGGGGGGGGGGGFFGGGGGGGGGGGGGGGGGGGGGGGGGGGGGGGGGGGGGGGGGGGFFGGGGGW
WGGGGGGGGGGGGGGGGGGGGGGGGGGGFGGGGGGGGGGGGGGGGGGGGGGGGGGGGGGGGGGGGGGGGGGGGGGGGGGGGGGGGGGFGGGGGGW
WGGGGFFFGGGGGGGGGGGGGGGGGGGGGGGGGGGFFGGGGGGGGGGGGGGGGGGGGGGGGGGGGGGGGGGGGGGGGGGGGGGGFGGGGFFGGGW
WGGGGGFGGTGGGGGGGGGGGGGGGGGGGGGGGGGGGGGGGGGGGGGGGGGGGGGGGGGGGGGGGGGGGGGGGGGGGGGGGFFGGGGGGGGGGGW
WGGGGGGGGGGGGGGGGGGGGGGGFFFGGGGGGGGGGGGGGGGGGGGGGGGGGGGGGGGGGGGGGGGGGGGGGGGGGGGGGGGGFFGGGGGGGGW
WGGGGGGGGGGGGGGGGGGGGGGGGGGGFGGGGGGGGGGGGGWWWWWWWWWWWWWWWWWWWWWWWWWWWWWWWWWWGGGGGGGGGGGGGGGGGGW
WGGGGGGGGGGGGGGGGGGGGGGGGGGFFGGGGGGGGGFFGGWGGGGGGGGGGGGGGGGGGGGGGGGGGGGGGGGWGGGGGGGGGGGGGGGGGGW
WGGGGGFFGGGGGGGGGGGGGGGGFFFGGGGGGGGGGGGGGGWGGGGGGGGGGGGGGGGGGGGGGGFFGGGGGGGWGGGGGGGGGGGFGGGGGGW
WGGGGGGFGGGGGGFGGGGGGGGGGGGGGGGGGGGGGGFGGGWGGGGGEGGGGGGGGFGGGGGGGGGGGGGGGGGWGGGGGGGGGGGGGGGGGGW
WGGGGGGGGGGGGGGGGGGGGGGGGGGGGGGGGGGGGGGGGGWGGGFFGGGGGGGGGGGGGGGGGGGGGGGGGGGWGGGGGGFFFGGGGGGGGGW
WGGGGGGGGGGGGGGGGGGGFFFGGGGGGGGGGGGGGGGGGGWGGGGGGGGGGGFFGGGGGGGHGGGGGGGGGGGWGGGFFGGGGGGGGGGGGGW
WGGGGGGGGGGGGGGGGGGGGGGGGGGGGFFGGGGGGGGGGGWGGGGGGGGGGGGGGGGGGGGGGGGGGGFFGGGWGGGGGGGGGGGGGGFGGGW
WGGGGGFFFGGGGFFGGGGGGGGGGGGGFFGGGGGGGGGGFFWGGGGGGGGFGGGGGGGGGGGGGGGGGGGGGGGWGGGGGGGGGGGGGGGGGGW
WGGGGFFGGGGGTGGGGGGGGGGGGFGFGGGGGGGGGGGGGGWGGGGGGGGGGGGGGGGGGGGGGGGGGGGGGGGWGGGGFGGGGGGGGGFFGGW
WGGGGGGGGGGGGGGGGGGGGGGGGFFGGGGGGGGGGGGGGGWGGGGGGPGGGGGGFFGGGGGGRRGGGGGGGGGWGGGFGGGGGGGGGGGGGGW
WGGGGGGGGGGGGGGGGGGGGGGGGGGGGGGGGFGGGGGGGGWGGGGGGGGGGGGGGGGGGGGRRRGGGGGGGGGWGGGGGGGGGGGGGGGGGGW
WGGGGGGGGGGGGFGGFFGGGGGGGGGGGGGGGGGGGGGGGGWGGGGGGGGGGGGGGGGGGGRRRGGGGGGGGGGWGGGGGGGGGGGFFFGGGGW
WGGFFGGGGGGGGGGGGGGGGGGGGGGGGGGGGGGGGGFFGGWGGGGGGGGGGFFFGGGGGRRRGGGGFFGGGGGWGGGGGGGGGGGGGGGGGGW
WGGGGGGGGGGGGFFGGGGGGGGGGFGGGGGGGGGGGGGGGGWGGGGGFGGGGGGGGGGGRRRGGGGGGGGGGFFWGGGGGGGGFGFFGGGFGGW
WGGGGGGGGGGGGGGGGGGGGGGGGFFFGGGGGGGGGGGGGGWGGGGGFGGGGGGGFFFRRGGGGGGGFFGGGGGWGGGGGGGGGGGGGGGGGGW
WGGGGGGGFFFFGGGGGGGGGGGGGGGGGGGGGGGGGGGGGGWGGFFGFGGGGGGGGGGGGGFGGGGGGGGGGGGWGGGGGGGGGGGFFFGGGGW
WGGGGGGGFFFFFFGGGGGGGGGGGGTGGGGGGGGGGGGGGGWGGGGGGGGGGGGGGGGGGGGGGGGAAAAAAAGWGGGGGGGGGGGGGGGGGGW
WGGGGGGGGGGGGGGGGGGGGGGGGGGGGGGGGGGGGGGGGGWGGGGGGGGGGGGGGGGGGFFGGGGAAAAAAAGWGGGGGGGGGGGGGGGGGGW
WGGGGGGGGFGGGGGGGGGGGGGGGGGGGGGGGGGGGFFGGGWGGGGGGGGGGGGGGGGGGGGGGGGAAAAAAAGWGGGGGGGTGGGGGGGGGGW
WGGGGGGGFGFFGGGGGGGGGGGGGGFGGGGGGGGGGGGGGGWGGGGGGGGGGGGGGGGGGGGGGGGAAAAAAAGWGGGGGGGGGGGGGGGGGGW
WGGGGGTGGFFFGGGGGGGGGGGGGFFGGGGGGGGGGGGGGGWGGGGGGGGGGGGGGGGGGGGGGGGAAAAAAAFWGGGGGGGGGGGGGGGGGGW
WGGGGGGGGGGGGGGGGGGGGGGGGGGGGGGGGGGGGFGGGFWFFGGGGGGGGGGGFGFFGGGGGGGAAAAAAAGWGGGGGGGGGGGGGGGGGGW
WGGGGGGGGGGFFGGGGGGGGGGFFFGGGGGGGGGGGGGGGGWFGGGGGGGGGGGGGFFGGGGGGGGAAAAAAAGWGGGGGGGGGGGFGGGGGGW
WGGGGGGGGGFFFFGGGGGGGGGGGGGGGGGGGGGGGGGGGGWFGGGGGGFFGGGGGGGGGGGGGFGAAAAAAAGWGGGGFFGGGGGGGGGGGGW
WGGGGGGGGGGGGGGGGGGGGGGGGGGGGGGGGGTGGGGGGGWGFGGGGGGGGGGGGGGGGGGGGGGGGGGGGGGWGGGGGGGGGGGGGGTGGGW
WGGGGGGGGGGGGGGGGGGGGGGGGGGGGGGGGGGGGGGGGGWWWWWWGGFFWWWWWWWWWWWWWWWWWWWWWWWWGGGGGGGGGGGGGGGGGGW
WGGGGGGGGGGGGGGGTGGGGGGGGGGGGFFGGGGGGGTGGGGGGGFFGGGGGGGGGGGGGGGGGGGGGGGGGGGGGGGGGGGGGFGGGGGGGGW
WGGGGGGFFGGGGGGGGGGGGGGGGGGFFFGGGGGGGGGGGGGGGGGGGGGGGGGGGGGGGGGGGGGGGGFGGGGGGGGGGGGGGGGGGGGGGGW
WGGGGGGGGGGGGGGGGGGGGGGGGFFFFFGGGGGGGGGGGGGGGGGGGGGGGGGGGFGGGGFGGGGGGGGGGGGGGGGGGGGGFFFGGGGGGGW
WGGFGGGGFFGGGGGGGGGGGGGGGGGGGGGGGGGGGGFFGGGGGGGGGGGGFFGGGGGGGGGGGGGGGGGGGGGGGGGFGGGGGGGGGGGGGGW
WGGGGGGGGGGGGGGGGFFGGGGGGGGGFGGGGGGGGGGGGGGGGGGGGGGGGGGGGGGGGGGGFFFFFGGGGGGGGGGGGGGGGGGGGGGGGGW
WGGGGGGGGGGGGGGGGGGGGGGGGFGGGGGGGGGGGGGGFGGGGGGGGGGGGGGGGGGGGGGGGGGGGGGGGGGGTGGGGGGGGGGGGGGGGGW
WGGGGGGGGGGGGGGGGGGGGGGGGGGGGGGGGGGGGGGGGGGGGGGGGGGGGGGGGGGGGGGGGGGGGGGGGGGGGGGGGGGGGGGGGGGGGGW
WWWWWWWWWWWWWWWWWWWWWWWWWWWWWWWWWWWWWWWWWWWWWWWWWWWWWWWWWWWWWWWWWWWWWWWWWWWWWWWWWWWWWWWWWWWWWWW
